+---------------------------+
|          |                |
|------+   +    +-------+   |
|                       |   |
|  +   +----------------+   |
|  |   |                    |
|  |   +------------+   +---|
|  |                    |   |
|  +----------------+   |   |
|                   |   |   |
|-------------------+   +   |
|                           |
|     |---------------------|
|  +--|                     |
|     |    +----------------|
|                          0|
+---------------------------+