+------------------+
|      |          3|
|----+ + +----+ +--|
|             |    |
| + +---------+    |
| | |1             |
| | +-----+ +------|
| |         |      |
| +-------+ | | +-+|
|        2| |3| |  |
|---------+ +-+ +  |
|   #              |
|+-------------+ +-|
|                |0|
| +  +-+---------+ |
| |    |         | |
| |  |3|    2|   | |
| +----+-----+   + |
|                  |
+------------------+